{
    "map_size": 25,
    "map_data": [
      [3, 49, 12, 35, 20, 43, 29, 6, 45, 19, 50, 17, 26, 35, 33, 45, 39, 14, 48, 21, 8, 32, 25, 48, 42],
      [33, 44, 36, 27, 29, 30, 12, 48, 8, 14, 1, 21, 35, 0, 29, 13, 9, 17, 29, 1, 12, 9, 47, 16, 8],
      [17, 36, 5, 50, 8, 31, 33, 29, 19, 20, 50, 12, 9, 15, 16, 40, 23, 8, 3, 12, 41, 11, 38, 50, 13],
      [38, 35, 33, 28, 22, 8, 24, 27, 0, 11, 7, 1, 33, 26, 41, 15, 10, 14, 47, 22, 1, 24, 2, 17, 3],
      [13, 0, 11, 40, 17, 3, 21, 27, 9, 12, 12, 5, 44, 2, 29, 20, 45, 44, 0, 46, 26, 31, 16, 41, 18],
      [28, 35, 14, 12, 45, 31, 35, 12, 27, 21, 44, 11, 21, 2, 25, 0, 46, 27, 22, 35, 18, 30, 11, 50, 48],
      [18, 18, 22, 8, 27, 31, 24, 46, 17, 1, 19, 16, 16, 19, 0, 38, 8, 6, 23, 12, 5, 1, 49, 22, 12],
      [38, 0, 7, 29, 44, 44, 48, 22, 50, 12, 24, 11, 9, 18, 16, 2, 30, 21, 18, 10, 26, 46, 10, 36, 13],
      [18, 47, 25, 30, 14, 13, 29, 45, 31, 45, 37, 1, 16, 10, 15, 3, 4, 27, 41, 4, 38, 22, 49, 50, 6],
      [19, 30, 45, 5, 3, 31, 28, 2, 21, 1, 18, 36, 49, 24, 47, 36, 46, 10, 11, 19, 14, 48, 11, 3, 25],
      [2, 42, 17, 38, 7, 27, 4, 17, 33, 9, 27, 13, 4, 28, 44, 46, 47, 16, 37, 25, 41, 48, 25, 8, 9],
      [14, 19, 42, 48, 19, 21, 45, 19, 20, 49, 16, 0, 27, 8, 15, 15, 44, 48, 46, 36, 3, 3, 48, 20, 30],
      [12, 31, 50, 5, 7, 38, 22, 18, 41, 2, 6, 9, 21, 50, 2, 50, 5, 44, 7, 27, 16, 8, 37, 15, 41],
      [30, 28, 44, 5, 15, 44, 33, 48, 4, 44, 1, 1, 14, 28, 30, 30, 13, 21, 48, 33, 14, 47, 13, 11, 31],
      [30, 38, 2, 17, 29, 47, 50, 37, 47, 17, 25, 30, 21, 37, 4, 48, 13, 25, 33, 27, 48, 24, 50, 33, 47],
      [3, 4, 13, 23, 21, 31, 33, 4, 3, 47, 6, 13, 27, 25, 27, 38, 24, 23, 7, 1, 2, 7, 23, 1, 14],
      [38, 27, 35, 1, 20, 47, 50, 7, 13, 49, 50, 33, 35, 8, 17, 11, 11, 7, 8, 46, 35, 28, 33, 45, 9],
      [10, 2, 23, 22, 20, 2, 37, 14, 12, 10, 48, 22, 28, 12, 8, 48, 47, 4, 29, 15, 46, 49, 18, 1, 47],
      [24, 28, 38, 5, 13, 38, 2, 2, 3, 5, 23, 22, 36, 23, 22, 16, 11, 11, 41, 30, 26, 11, 23, 13, 44],
      [3, 46, 36, 49, 33, 22, 4, 18, 15, 3, 11, 29, 26, 13, 4, 6, 23, 16, 50, 0, 50, 31, 45, 5, 41],
      [15, 3, 9, 10, 35, 26, 35, 0, 25, 46, 50, 46, 46, 3, 18, 30, 33, 23, 37, 22, 1, 33, 6, 1, 24],
      [27, 10, 37, 18, 22, 21, 0, 19, 13, 10, 50, 41, 50, 36, 1, 9, 44, 5, 12, 7, 47, 8, 25, 25, 5],
      [28, 26, 50, 33, 31, 15, 29, 27, 31, 18, 26, 37, 12, 8, 24, 23, 4, 7, 4, 7, 3, 44, 33, 18, 22],
      [23, 35, 47, 23, 38, 20, 17, 19, 2, 1, 14, 20, 41, 29, 8, 15, 19, 38, 41, 33, 18, 19, 3, 3, 47],
      [47, 26, 9, 7, 20, 24, 14, 50, 10, 19, 2, 23, 46, 19, 41, 9, 31, 4, 20, 20, 6, 15, 45, 37, 33]
    ]
  }
  