{
  "map_data": [
    [11, 15, 13, 12, 16, 101, 109, 105, 103, 102, 15, 12, 104, 108, 106, 101, 11, 14, 16, 104, 107, 103, 110, 14, 13],
    [105, 15, 16, 109, 107, 101, 14, 102, 110, 13, 15, 104, 12, 108, 106, 11, 103, 14, 16, 105, 12, 102, 101, 13, 107],
    [14, 12, 103, 101, 15, 107, 104, 110, 109, 102, 105, 14, 16, 12, 106, 101, 104, 11, 13, 108, 15, 103, 102, 107, 109],
    [105, 12, 109, 14, 13, 102, 101, 16, 107, 15, 110, 11, 103, 108, 104, 12, 106, 102, 13, 101, 105, 109, 14, 15, 16],
    [15, 104, 107, 102, 109, 106, 14, 11, 103, 108, 12, 101, 13, 16, 15, 105, 102, 110, 14, 109, 101, 13, 12, 107, 16],
    [102, 13, 104, 101, 110, 14, 12, 105, 107, 15, 103, 108, 109, 16, 11, 13, 101, 102, 106, 14, 15, 12, 107, 110, 104],
    [102, 101, 15, 14, 12, 110, 105, 13, 109, 16, 104, 103, 107, 11, 101, 102, 108, 15, 14, 106, 13, 12, 16, 109, 105],
    [107, 103, 13, 109, 15, 102, 101, 12, 16, 105, 104, 14, 110, 108, 11, 107, 13, 12, 102, 101, 15, 109, 14, 106, 16],
    [108, 102, 15, 14, 12, 105, 107, 103, 101, 109, 16, 104, 11, 13, 106, 14, 102, 15, 101, 110, 109, 12, 107, 13, 16],
    [108, 15, 103, 104, 11, 107, 101, 13, 109, 102, 14, 12, 106, 110, 16, 105, 101, 13, 102, 15, 109, 14, 107, 108, 12],
    [110, 15, 107, 102, 13, 105, 108, 103, 101, 14, 104, 12, 11, 109, 106, 101, 102, 16, 15, 14, 109, 107, 13, 12, 110],
    [101, 108, 16, 105, 103, 14, 15, 107, 110, 13, 12, 102, 109, 104, 101, 14, 106, 11, 15, 102, 13, 109, 107, 12, 101],
    [13, 110, 101, 15, 102, 105, 14, 103, 104, 107, 16, 109, 108, 12, 106, 101, 13, 11, 102, 15, 109, 14, 107, 12, 110],
    [101, 105, 107, 12, 14, 109, 102, 13, 110, 103, 15, 108, 104, 101, 11, 16, 106, 13, 15, 107, 102, 109, 12, 14, 101],
    [105, 107, 109, 14, 15, 102, 101, 12, 16, 13, 108, 104, 110, 106, 101, 103, 14, 102, 11, 13, 107, 109, 15, 12, 105],
    [14, 101, 109, 103, 105, 102, 15, 107, 12, 13, 14, 110, 104, 16, 108, 101, 11, 109, 106, 107, 12, 102, 15, 13, 14],
    [108, 15, 107, 13, 105, 12, 102, 103, 101, 14, 16, 110, 109, 104, 101, 14, 106, 13, 107, 11, 109, 102, 15, 12, 108],
    [105, 107, 109, 14, 15, 102, 101, 12, 16, 13, 108, 104, 110, 106, 101, 103, 14, 102, 11, 13, 107, 109, 15, 12, 105],
    [14, 101, 109, 103, 105, 102, 15, 107, 12, 13, 14, 110, 104, 16, 108, 101, 11, 109, 106, 107, 12, 102, 15, 13, 14],
    [108, 15, 107, 13, 105, 12, 102, 103, 101, 14, 16, 110, 109, 104, 101, 14, 106, 13, 107, 11, 109, 102, 15, 12, 108],
    [105, 107, 109, 14, 15, 102, 101, 12, 16, 13, 108, 104, 110, 106, 101, 103, 14, 102, 11, 13, 107, 109, 15, 12, 105],
    [14, 101, 109, 103, 105, 102, 15, 107, 12, 13, 14, 110, 104, 16, 108, 101, 11, 109, 106, 107, 12, 102, 15, 13, 14],
    [108, 15, 107, 13, 105, 12, 102, 103, 101, 14, 16, 110, 109, 104, 101, 14, 106, 13, 107, 11, 109, 102, 15, 12, 108],
    [105, 107, 109, 14, 15, 102, 101, 12, 16, 13, 108, 104, 110, 106, 101, 103, 14, 102, 11, 13, 107, 109, 15, 12, 105],
    [14, 101, 109, 103, 105, 102, 15, 107, 12, 13, 14, 110, 104, 16, 108, 101, 11, 109, 106, 107, 12, 102, 15, 13, 14]
  ]
}
