{
  "map_data": [
    [11, 12, 12, 13, 14, 15, 16, 16, 15, 14, 13, 12, 11, 12, 12, 13, 14, 15, 16, 16, 15, 14, 13, 12, 11],
    [12, 13, 14, 15, 16, 16, 15, 14, 13, 12, 11, 12, 12, 13, 14, 15, 16, 16, 15, 14, 13, 12, 11, 12, 12],
    [12, 13, 14, 15, 16, 16, 15, 14, 13, 12, 11, 12, 12, 13, 14, 15, 16, 16, 15, 14, 13, 12, 11, 12, 12],
    [13, 14, 15, 16, 16, 15, 14, 13, 12, 11, 12, 12, 13, 14, 15, 16, 16, 15, 14, 13, 12, 11, 12, 12, 13],
    [14, 15, 16, 16, 15, 14, 13, 12, 11, 12, 12, 13, 14, 15, 16, 16, 15, 14, 13, 12, 11, 12, 12, 13, 14],
    [15, 16, 16, 15, 14, 13, 12, 11, 12, 12, 13, 14, 15, 16, 16, 15, 14, 13, 12, 11, 12, 12, 13, 14, 15],
    [16, 16, 15, 14, 13, 12, 11, 12, 12, 13, 14, 15, 16, 16, 15, 14, 13, 12, 11, 12, 12, 13, 14, 15, 16],
    [16, 15, 14, 13, 12, 11, 12, 12, 13, 14, 15, 16, 16, 15, 14, 13, 12, 11, 12, 12, 13, 14, 15, 16, 16],
    [15, 14, 13, 12, 11, 12, 12, 13, 14, 15, 16, 16, 15, 14, 13, 12, 11, 12, 12, 13, 14, 15, 16, 16, 15],
    [14, 13, 12, 11, 12, 12, 13, 14, 15, 16, 16, 15, 14, 13, 12, 11, 12, 12, 13, 14, 15, 16, 16, 15, 14],
    [13, 12, 11, 12, 12, 13, 14, 15, 16, 16, 15, 14, 13, 12, 11, 12, 12, 13, 14, 15, 16, 16, 15, 14, 13],
    [12, 11, 12, 12, 13, 14, 15, 16, 16, 15, 14, 13, 12, 11, 12, 12, 13, 14, 15, 16, 16, 15, 14, 13, 12],
    [11, 12, 12, 13, 14, 15, 16, 16, 15, 14, 13, 12, 11, 12, 12, 13, 14, 15, 16, 16, 15, 14, 13, 12, 11],
    [12, 13, 14, 15, 16, 16, 15, 14, 13, 12, 11, 12, 12, 13, 14, 15, 16, 16, 15, 14, 13, 12, 11, 12, 12],
    [12, 13, 14, 15, 16, 16, 15, 14, 13, 12, 11, 12, 12, 13, 14, 15, 16, 16, 15, 14, 13, 12, 11, 12, 12],
    [13, 14, 15, 16, 16, 15, 14, 13, 12, 11, 12, 12, 13, 14, 15, 16, 16, 15, 14, 13, 12, 11, 12, 12, 13],
    [14, 15, 16, 16, 15, 14, 13, 12, 11, 12, 12, 13, 14, 15, 16, 16, 15, 14, 13, 12, 11, 12, 12, 13, 14],
    [15, 16, 16, 15, 14, 13, 12, 11, 12, 12, 13, 14, 15, 16, 16, 15, 14, 13, 12, 11, 12, 12, 13, 14, 15],
    [16, 16, 15, 14, 13, 12, 11, 12, 12, 13, 14, 15, 16, 16, 15, 14, 13, 12, 11, 12, 12, 13, 14, 15, 16],
    [16, 15, 14, 13, 12, 11, 12, 12, 13, 14, 15, 16, 16, 15, 14, 13, 12, 11, 12, 12, 13, 14, 15, 16, 16],
    [15, 14, 13, 12, 11, 12, 12, 13, 14, 15, 16, 16, 15, 14, 13, 12, 11, 12, 12, 13, 14, 15, 16, 16, 15],
    [14, 13, 12, 11, 12, 12, 13, 14, 15, 16, 16, 15, 14, 13, 12, 11, 12, 12, 13, 14, 15, 16, 16, 15, 14],
    [13, 12, 11, 12, 12, 13, 14, 15, 16, 16, 15, 14, 13, 12, 11, 12, 12, 13, 14, 15, 16, 16, 15, 14, 13],
    [12, 11, 12, 12, 13, 14, 15, 16, 16, 15, 14, 13, 12, 11, 12, 12, 13, 14, 15, 16, 16, 15, 14, 13, 12],
    [11, 12, 12, 13, 14, 15, 16, 16, 15, 14, 13, 12, 11, 12, 12, 13, 14, 15, 16, 16, 15, 14, 13, 12, 11]
  ]
}
